11111111111
10E00000001
10000010C01
10P00010001
11111111111
