11111111111
10E00000001
10000010001
10P00010001
10000000001
11111111111
