11111111111
10E00000001
10000010C01
10P00011101
10000010101
11111111111
