11111111111
10E00000001
10000010C01
10P00011101
1000001C101
11111111111
