11111111111
10E00000001
10000010C01
10000011101
1000001P101
11111111111
